XXXXXXXXXXXXXXXXXXXX
DDDDDDDDDDDDDDDDDDDD
DDDDDDDDDDDDDDDDDDDD
DDDDDGDDDDXDDDDDDDDD
DDDDDDDDDDXDDDDDDDDD
DDDDDDDDDDXGXDDDDDDD
DDDDDRDDDDXDDDDRDDDD
DXGXXDXXGXXDDDDDDDDD
DDDDDDDDDDDDDDDDDDDD
DDDDDDDDDDDDDDXXXDDD
DXGXDDDDDDHDDDDDDDDD
DDDDDDDDDDXDDDDDDDDD
DDDDDDDDDDXDDDDDDDDD
DDDDDDDDDDXDDDDDDDDD
DDDDDDDDDDXDDDDDDDDD
DDDDRDDDDDGDDDDRDDDD
DDDDDDDDDDDDDDDDDDDD
DDDDDDDDDDXDDDDDDDDD
DDDDDDDDDDDDDDDDDDDD
DDDDDDDDDDDDDDDDDDDD