XXXXXXXXXXXXXXXXXXXX
DDDDDDDDDDDDDDDDDDDD
DDDDDDDDDDDDDDDDDDDD
DDDDXXXGXXXDDDDDDDDD
DDDDDDDDDDDDDDDDDDDD
DDDDDDDDDXDDDDDDDDDD
DDXXSXXDDXDDDDDDDDDD
DDDDDDDDDXDDDDDDDDDD
DDDDDDDDDXDDDDDDDDDD
DDDDDDDDDXDDDDRDDDDD
DDRDDDDDDXDDDDDDDDDD
DDDDDDDDDXDDDDDDDDDD
DXGXXDDDDHDDDXXGXXXX
DDDDDDDDDDDDDDDDDDDD
DDDDDDDDDDDDDDDDDDDD
DDDDDDDDDDDDDDDDDDDD
DDDDDDDDDDDDDDDDDDDD
DDDDDDDDDXXXXGXDDDDD
DDDDDDDDDDDDDDDDDDDD
DDDDDDDDDDDDDDDDDDDD