XXXXXXXXXXXXXXXXXXXX
DDDDDDDDDDDDDDDDDDDD
DDDDXBXXDDDDDDDDDDDD
DDDDXXXXDDDDDDXXGXDD
DDDDDDDDDDDDDDDDDDDD
DDXXGXDDDXDDDDDDDDDD
DDDDDDDDDXDDDDDDDDDD
DDDDDDDDDXDDDDDRDDDD
DDDDDDDDDXDDDDDDDDDD
DDDDDDDDDXDDDXXGXXXX
DDDDRDDDDXDDDDDDDDDD
DDDDDDDDDXDDDDDDDDDD
XXGXXDDDDHDDDDDDDDDD
DDDDDDDDDDDDDDDDDDDD
DDDDDDDDDDDDDDDDDDDD
DDDDDDDDDDDDDDDRDDDD
DDDDDDDDDDDDDDDDDDDD
DRDDDDDDDDDDDDDDDDDD
DDDDDDDXGXDDDDDDDDDD
DDDDDDDDDDDDDDDDDDDD